1 13 31
###############################
#p    x** *    *   *  * * *   #
# # # #*# # #*#*# # # #*#*#*# #
#b  **    ***  *      *   * * #
#s#*# # # #*# # #*#*# # # # #*#
#f1   *      **  *  *         #
# # # # # # # # # #*# #*# # # #
#*  **     *  *      *        #
# #*# # #*# # # #*#*# # # # # #
#*    **  *       *           #
# #*# # # # # # #*# # # # # # #
#           *   *  *          #
###############################

